border_size=1
usage=map

Xuc         , Xuc         , Xuc         , Xuc         , Xuc         , Xuc         , Xuc         , Xuc         , Ur          , Ur          , Ur          , Xuc         , Xuc         , Xuc         , Xuc         , Xuc         , Xuc         , Xuc         , Xuc         , Xuc         , Xuc         , Xuc         , Xuc         , Xuc         , Xuc         , Xuc         , Xuc         
Xuc         , Xuc         , Xuc         , Xuc         , Xuc         , Xuc         , Ur          , Ur          , Ur          , Ur          , Xuc         , Xuc         , Xuc         , Xuc         , Xuc         , Xuc         , Xuc         , Xuc         , Xuc         , Xuc         , Xuc         , Xuc         , Xuc         , Xuc         , Xuc         , Xuc         , Xuc         
Xuc         , Xuc         , Xuc         , Xuc         , Uu          , Ur          , Ur          , Ur          , Xuc         , Xuc         , Xuc         , Xuc         , Xuc         , Xuc         , Xuc         , Xuc         , Xuc         , Xuc         , Xuc         , Xuc         , Xuc         , Xuc         , Xuc         , Xuc         , Xuc         , Xuc         , Xuc         
Xuc         , Xuc         , Xuc         , Uu          , Uu          , Ur          , Ur          , Xuc         , Uu          , Xuc         , Uu          , Uue         , Xuc         , Xuc         , Xuc         , Xuc         , Xuc         , Xuc         , Xuc         , Xuc         , Xuc         , Xuc         , Xuc         , Xuc         , Xuc         , Xuc         , Xuc         
Xuc         , Xuc         , Xuc         , Uu          , Uu          , Ur          , Ur          , Uu          , Uu          , Uu          , Uue         , Uu          , Uue         , Xuc         , Xuc         , Xuc         , Xuc         , Xuc         , Xuc         , Xuc         , Xuc         , Xuc         , Xuc         , Xuc         , Xuc         , Xuc         , Xuc         
Xu          , Xu          , Xu          , Uu          , Uu          , Ur          , Ur          , Uu          , Xu          , Uu          , Xu          , Uue         , Xu          , Xu          , Xu          , Xu          , Xu          , Xu          , Wog         , Wog         , Wog         , Wog         , Wog         , Xuc         , Xuc         , Xuc         , Xuc         
Xu          , Xu          , Xu          , Xu          , Xu          , Ur          , Ur          , Ur          , Ur          , Xu          , Xu          , Xu          , Xu          , Xu          , Xu          , Xu          , Xu          , Wog         , Wog         , Wog         , Xu          , Wog         , Wog         , Wog         , Wog         , Wog         , Wog         
Xu          , Xu          , Uue         , Xu          , Uu          , Xu          , Uu          , Ur          , Ur          , Ur          , Ur          , Xu          , Xu          , Xu          , Xu          , Wog         , Wog         , Wog         , Xu          , Xu          , Xu          , Xu          , Xuc         , Wog         , Wog         , Wog         , Xuc         
Xu          , Uue         , Uue         , Uue^Em      , Uue         , Uu          , Uu          , Uu          , Uu          , Ur          , Ur          , Ur          , Xu          , Xu          , Wwg         , Wwg         , Xu          , Xu          , Xu          , Xu          , Xu          , Xu          , Xuc         , Xuc         , Xuc         , Xuc         , Xuc         
Xu          , Xu          , Uue         , Uue         , Uue         , Uue^Em      , Uue         , Uue         , Uue         , Uu          , Ur          , Ur          , Sm          , Wwg         , Xu          , Wwg         , Xu          , Xu          , Xu          , Xu          , Xu          , Xu          , Xuc         , Xuc         , Xuc         , Xuc         , Xuc         
Xu          , Xu          , Xu          , Xu          , Xu          , Uue         , Xu          , Uue         , Xu          , Uu          , Sm          , Sm^Bw\r     , Sm          , Sm          , Xu          , Xu          , Xu          , Xu          , Xu          , Xu          , Xu          , Xu          , Xuc         , Xuc         , Xuc         , Xuc         , Xuc         
Xu          , Xu          , Xu          , Xu          , Xu          , Xu          , Xu          , Xu          , Xu          , Xu          , Sm          , Sm          , Wwg         , Wwg         , Wwg^Bw\r    , Xu          , Xu          , Xu          , Xu          , Xu          , Xu          , Xu          , Xuc         , Xuc         , Xuc         , Xuc         , Xuc         
Xu          , Xu          , Xu          , Xu          , Xu          , Xu          , Xu          , Xu          , Xu          , Sm          , Sm          , Sm          , Xu          , Wwg         , Ur          , Ur          , Ur          , Xu          , Xu          , Xu          , Xu          , Xu          , Xuc         , Xuc         , Xuc         , Xuc         , Xuc         
Wog         , Xu          , Xu          , Xu          , Wog         , Xu          , Xu          , Xu          , Wog         , Wog         , Sm          , Sm          , Xu          , Xu          , Uu          , Ur          , Ur          , Ur          , Ur          , Uu          , Uu          , Xu          , Xuc         , Xuc         , Uh          , Xuc         , Uh          
Wog         , Wog         , Wog         , Wog         , Wog         , Wog         , Wog         , Wog         , Wog         , Sm          , Xu          , Xu          , Xu          , Uu          , Uu          , Uu          , Uu          , Uu          , Uu          , Uu          , Uu          , Xu          , Xuc         , Uh          , Uh          , Uh          , Xuc         
Xu          , Wog         , Xuc         , Wog         , Xu          , Xu          , Xu          , Xu          , Xu          , Xu          , Xu          , Xu          , Xu          , Xu          , Xu          , Uu^Em       , Uu          , Uu^Em       , Uu^Em       , Uu          , Uu          , Uu          , Uh          , Uh          , Uh          , Uh          , Xuc         
Xu          , Xu          , Xu          , Xu          , Xu          , Xu          , Xu          , Xu          , Xu          , Xu          , Xu          , Xu          , Xu          , Xu          , Xu          , Uu          , Xuc         , Uu          , Uu          , Uu          , Uu          , Uu          , Uh          , Uh          , Xuc         , Xuc         , Xuc         
Xu          , Xu          , Xu          , Xu          , Xu          , Xu          , Xu          , Xu          , Xu          , Xu          , Xu          , Xu          , Xu          , Xu          , Xu          , Xu          , Xuc         , Uu          , Xuc         , Xu          , Xu          , Xu          , Xuc         , Xuc         , Xuc         , Xuc         , Xuc         
Xu          , Xu          , Xu          , Xu          , Xu          , Xu          , Xu          , Xu          , Xu          , Xu          , Xu          , Xu          , Xu          , Xu          , Xu          , Xu          , Xu          , Xuc         , Xuc         , Xu          , Xu          , Xu          , Xuc         , Xuc         , Xuc         , Xuc         , Xuc         
Xu          , Xu          , Xu          , Xu          , Xu          , Xu          , Xu          , Xu          , Xu          , Xu          , Xu          , Xu          , Xu          , Xu          , Xu          , Xu          , Xu          , Xuc         , Xuc         , Xu          , Xu          , Xu          , Xuc         , Xuc         , Xuc         , Xuc         , Xuc         
Xu          , Xu          , Xu          , Xu          , Xu          , Xu          , Xu          , Xu          , Xu          , Xu          , Xu          , Xu          , Xu          , Xu          , Xu          , Xu          , Xu          , Xuc         , Xuc         , Xuc         , Xuc         , Xuc         , Xuc         , Xuc         , Xuc         , Xuc         , Xuc         
Xu          , Xu          , Xu          , Xu          , Xu          , Xu          , Xu          , Xu          , Xu          , Xu          , Xu          , Xu          , Xu          , Xu          , Xu          , Xu          , Xu          , Xuc         , Xuc         , Xuc         , Xuc         , Xuc         , Xuc         , Xuc         , Xuc         , Xuc         , Xuc         
